111111111111111
1000000000000P1
100001000000101
111100000010101
100000000010101
1000P0001111101
100000000000001
100000000000001
111111000111101
1P00000000000P1
111111111111111