		1111111111111111111111111 1
		10000000001100000000001   1
		1011000001110000000000001 1
		1001000000000000000000001 1 
111111111011000001110000000000001 1
100000000011000001110111111111111 1 
11110111111111011100000010001     1
11110111111111011101010010001     1
11000000110101011100000010001     1
10000000000000001100000010001     1
10000000000000001101010010001     1
11000001110101011111011110N0111   1
11110111 1110101 101111010001     1
11111111 1111111 111111111111     1