111111111111111
1000000000000P1
100001000000101
111100100010101
100000000010101
100000001111101
100000000000001
100000000000001
111111000111101
100000000000001
111111111111111